#################################
#                               #
#                               #
#          !       !            #
#                               #
#   !                     !     #
#                               #
#                               #
#                     !         #
#                               #
#          ####                 #
#      !     ##                 #
#            ##           !     #
#            ##  !              #
#                               #
#                               #
#      !                        #
#                               #
#                               #
# !                !       !    #
#           !                   #
#                               #
#################################
