####################
#       !          #
#             !    #
#    !             #
#          !       #
#                  #
#                  #
#                  #
#    !  EIMG       #
#       OACL    !  #
#       KDBP       #
#       HNJF       #
#                  #
#    !         !   #
#                  #
#          !       #
#                  #
#               !  #
#       !          #
####################