#####
#! !#
# A #
#! !#
#####
