#######################
#                    !#
# !  !  !        !    #
#                     #
#      !     !        #
#   ###            !  #
# ! ###               #
#   ###       !       #
#         !        !  #
#!                    #
#   !                 #
#              !     !#
#       !         ##  #
#                 ##  #
#                 ##  #
#  !              ##  #
#      !  AAA     ##  #
#         AAA     ##  #
#         AAA     ##  #
#         AAA         #
#!  ##    AAA   !     #
#   ##                #
#  !## !             !#
#   ##                #
#                  !  #
#          !    !     #
#                     #
#      !           !  #
# !        !          #
#     !               #
#                !    #
#  !                  #
#      #########     !#
#      #########      #
#                     #
# !               !   #
#                     #
#    !         !     !#
#         !           #
#!  !              !  #
#      !              #
#              !      #
#######################
