#######################
#          !          #
#  !            !     #
#       !           ! #
#                     #
#              ###    #
#  !        !   ##    #
#      !        ##    #
#                     #
# !                   #
#       !           ! #
#                     #
#    !         !  !   #
#                     #
#                     #
#  !     AAAA         #
#        AAAA         #
#    !   AAAA   !    !#
#        AAAA         #
#                     #
#                     #
# !                   #
#        !         !  #
#  ####     !         #
#   ###               #
#   ###         !     #
#    !                #
#                    !#
# !       !           #
#                     #
#    !                #
#             ####    #
#              ###    #
#           !  ###    #
#  !    !           ! #
#                     #
#                     #
#     !             ! #
#             !       #
#                     #
#!                !   #
#     !               #
#######################
