####################
#!   !   !   !   ! #
#                  #
#                  #
#                  #
#!   !   !   !   ! #
#                  #
#      KLMNO       #
#      JABCP       #
#!   ! IH!DQ !   ! #
#      XGFER       #
#      WVUTS       #
#                  #
#!   !   !   !   ! #
#                  #
#                  #
#                  #
#!   !   !   !   ! #
#                  #
####################