####################
#!############# !###
##  #######       ##
#### ###  !       ##
##                ##
##        EFGH     #
#   !     IABJ     #
#####     KCDL     #
####    ! MNOP!   ##
##!               ##
##               ###
##       ##! ### ###
##  #            ###
##  ###   ##########
##  !####   ########
#########       ####
#####!      ### !###
####################
####################
####################