#######################
#    !          !     #
# ###                 #
# ###       !      !  #
#                     #
#                     #
# !      !  !      !  #
#    !                #
#                     #
#                ###  #
#          ##   !###  #
#          ##         #
#!   !    ###        !#
#         ### !       #
#         ###         #
#                 !   #
#       !             #
# !                  !#
#              !      #
#   !      !      !   #
#                     #
#                     #
#                  !  #
# ###     AAAA        #
# ###  !  AAAA  !     #
# ###     AAAA        #
#  !      AAAA        #
#                     #
#                   ! #
#          !          #
#              ###    #
#  !   !        ##    #
#               ##    #
#               ##    #
#!         !        ! #
#    !                #
#                 !   #
#                   ! #
# !   !        !      #
#                     #
#                  !  #
#        !            #
#######################
