###########################################
#                                         #
#                                         #
#   !                              !      #
#                                     ### #
#                                     ### #
#                                      ## #
#                                      ## #
#              ###      !                 #
#               ##  AAAA                  #
#               ##  AAAA                  #
#     !             AAAA                  #
#                                         #
#                                   !     #
#                                         #
#                                         #
#          !                   ###        #
#                        !      ##        #
#                               ##        #
#                               ##        #
#  !                            ##      ! #
#                                         #
###########################################
