#######################
#                     #
#                     #
#                     #
#                     #
#    ###          !   #
#     ##              #
#     ##              #
#     ##              #
#          !          #
#                     #
#                     #
#                     #
#                     #
#  !                  #
#                     #
#                  !  #
#                     #
#                     #
#           !         #
#         AAA         #
#         AAA         #
#         AAA         #
#  !                  #
#       ###           #
#       ###       !   #
#       ##            #
#       ##            #
#       ##            #
#                     #
#                     #
#                     #
#    !                #
#                     #
#                #### #
#                #### #
#         !        ## #
#                  ## #
#                  ## #
#                     #
#                     #
#                     #
#######################
